{
    "tiles" : [ [1, 1, 1, 0, 0, 0, 1, 1, 1 ],
               [1, 1, 1, 1, 1, 1, 1, 1, 1 ],
               [1, 1, 1, 0, 0, 0, 1, 1, 1 ],
               [1, 1, 1, 1, 1, 1, 1, 1, 1 ],
               [0, 0, 1, 0, 0, 0, 1, 0, 0 ],
               [1, 1, 1, 1, 1, 1, 1, 1, 1 ],
               [1, 1, 1, 0, 0, 0, 1, 1, 1 ],
               [1, 1, 1, 1, 1, 1, 1, 1, 1 ],
               [1, 1, 1, 0, 0, 0, 1, 1, 1 ] ],
    
    "targetScore" : 1200,
    "moves" : 10,
}
